officeholder	office
airport	air
railwayline	railway
airline	air
militaryunit	military
village	villa
administrativeregion	administrative
architecturalstructure	architectural
politicalparty	political
musicalartist	music
militaryconflict	military
governor	governorate
recordlabel	record
personfunction	person
musicgenre	music
musicalwork	music
fictionalcharacter	fictional
fictionalcharacter	fiction
icehockeyplayer	ice
militaryperson	military